XXXXX X X XXXXX
XX    X X   XXX
XXX XXX XXX XXX
X     X X     X
X XXX X X XXX X