XXX XXX XXXXXXXXXXX
XXX XXX XXXXXXXXXXX
XXX           XXXXX
XXXXXXXXXX XX XXXXX
XXXXXXXXXX XX XXXXX
