XXXXX XXXXXX
X          X
X          X
X          X
X XXX XXXX X