XXXX XXXX XXXX XXXX XXXX
XXXX XXXX XXXX XXXX XXXX
XXXX  XX  XXXX  XX  XXXX
XXXXX    XXXXXX    XXXXX
XXXXXX  XXXXXXXX  XXXXXX
XXXXXX  XXXXXXXX  XXXXXX
XXXXXXX   XXXX   XXXXXXX
XXXXXXXXX  XX  XXXXXXXXX
XXXXXXXXXX    XXXXXXXXXX
XXXXXXXXXXX  XXXXXXXXXXX
XXXXXXXXXX    XXXXXXXXXX
XXXXXXXXX  XX  XXXXXXXXX
XXXXXXX   XXXX   XXXXXXX
XXXXXX  XXXXXXXX  XXXXXX
XXXXXX  XXXXXXXX  XXXXXX
XXXXX    XXXXXX    XXXXX
XXXX  XX  XXXX  XX  XXXX
XXXX XXXX XXXX XXXX XXXX
XXXX XXXX XXXX XXXX XXXX