XXXXX XXXXX XXXXXXXXXX XXXXXXXXXXXXXXXXXXX XXXXXXX XXXXXXXXXXX XXXXXXXXX XXX XXXXXXXXXX X
XXXXX        XXXXXX                  XXXXX XXXX       XXXXXXXXXXXXXXXXX   X  XXXXXXXX   X
XXXXX          XXXX     XXXXXXXX     XXXXX XX           XXXXXXXXXXXXXXXXX   XXXXXXX     X
XX          XX XXXX     XXXXXXXX     XXXXX XXX         XXXXXXXXXXXXXXXXXX XXXXXXX       X
XX          XX  XXX                  XXXXX XXXXX     XXXXXXXXXXXXXXXXXXX  XXXXX         X
XX          XX  XXXXXXXXXX    XXXXXXXXXXXX XXXXXXX XXXXXXXXXXXXXXXXXXX   XXXX           X
XX          XXX XXXXXXXXXX    XXXXXXXXXXXX XXXXXXX XXXXXXXXXXXXXXX     XXXX             X
XX          XXX XXXXXXXXXX    XXXXXXXXXXXX XXXXXXX XXXXXXXXXXXX    XXXXX                X
XX          XXX XXXXXXXXXX    XXXXXXXXXXXX XXXXXXX XXXXXXX      XXXXX                   X
XX          XXX XXXXXXXXXX          XXXXXX XXXXXXX XXXX    XXXXXXXXX                    X
XX          XXX XXXXXXXXXX    XXXXXXXXXXXX XXXXXXX XXXX XXXXXXXXXXXX                    X
XX          XXX XXXXXXXXXX        XXXXXXXX XXXXXXX XXXX      XXXXXXXXXX                 X
XX          XXX XXXXXXXXXX    XXXXXXXXXXXX XXXXXXX XXXXXXXX      XXXXXXXXXX             X
XX          XXX XXXXXXXXXX          XXXXXX XXXXXXX XXXXXXXXXXXX      XXXXXXXXXX         X
XX          XXX XXXXXXXXXX XXXXXXXXXXXXXXX XXXXXXX XXXXXXXXXXXXXXXXX XXXXXXXXXXXXXXXXXX X
XX          XXX                                                                         X
XXXXXXXXXXXXXXXXXXXXXXXXXXXXXXXXXXXXXXXXXX XXXXXXXXXXXXXXXXXXXXXXXXXXXXXXXXXXXXXXXXXXXXXX